


F 	255, 		255 ,  	 051


C        51 ,	156	,255

   		SO     texture/l.xpm



 	WE texture/r.xpm

		EA  texture/u.xpm

NO texture/d.xpm









       111111111111111111111111111111
       100000000000001000000000000101
       100111111110111111111111110101
       100010000010000000010000010001
1111111110101111110100000000000000001
10100000101000000101111111111111111111
1011111010111110110100111010101
100000101010000010010001010001
101110101011111010000111011101
101000100000001001W00100000001111111111
10101110111010111101011111010111111011111111
1010000000100010011	1	 10000000011111111101
11011111111111111111111111110110111111111111
1000011 10000001 1000000000001111101
1111111 11111111 111111111111111111