


F 	255, 		255 ,  	 051


C        51 ,	156	,255

   		SO     texture/l.xpm



 	WE texture/r.xpm

		EA  texture/u.xpm

NO texture/d.xpm









       111111111111111111111111111111
       100000000000001000000000000101
       100111111110111111111111110101
       100010000010000000010000010001
1111111110101111110100000000000000001
1010000010100000010111111111111111111
11110111111111011100000010001
11110111111111011101010010001
11000000110101011100000010001
10000000000000001100000010001
10000000000000001101010010001
11000001110101011111011110N0111
11110111 1110101 101111010001
11111111 1111111 111111111111